"1394ohci"	"\SystemRoot\System32\drivers\1394ohci.sys"	"signed but not trusted"
"3ware"	"System32\drivers\3ware.sys"	"signed but not trusted"
"ACPI"	"System32\drivers\ACPI.sys"	"signed but not trusted"
"AcpiDev"	"\SystemRoot\System32\drivers\AcpiDev.sys"	"signed but not trusted"
"acpiex"	"System32\Drivers\acpiex.sys"	"signed but not trusted"
"acpipagr"	"\SystemRoot\System32\drivers\acpipagr.sys"	"signed but not trusted"
"AcpiPmi"	"\SystemRoot\System32\drivers\acpipmi.sys"	"signed but not trusted"
"acpitime"	"\SystemRoot\System32\drivers\acpitime.sys"	"signed but not trusted"
"Acx01000"	"system32\drivers\Acx01000.sys"	"signed but not trusted"
"ADP80XX"	"System32\drivers\ADP80XX.SYS"	"signed but not trusted"
"AFD"	"\SystemRoot\system32\drivers\afd.sys"	"signed but not trusted"
"afunix"	"\SystemRoot\system32\drivers\afunix.sys"	"signed but not trusted"
"ahcache"	"system32\DRIVERS\ahcache.sys"	"signed but not trusted"
"amdgpio2"	"\SystemRoot\System32\drivers\amdgpio2.sys"	"signed but not trusted"
"amdi2c"	"\SystemRoot\System32\drivers\amdi2c.sys"	"signed but not trusted"
"AmdK8"	"\SystemRoot\System32\drivers\amdk8.sys"	"signed but not trusted"
"AmdPPM"	"\SystemRoot\System32\drivers\amdppm.sys"	"signed but not trusted"
"amdsata"	"System32\drivers\amdsata.sys"	"signed but not trusted"
"amdsbs"	"System32\drivers\amdsbs.sys"	"signed but not trusted"
"amdxata"	"System32\drivers\amdxata.sys"	"signed but not trusted"
"AppID"	"system32\drivers\appid.sys"	"signed but not trusted"
"applockerfltr"	"system32\drivers\applockerfltr.sys"	"signed but not trusted"
"arcsas"	"System32\drivers\arcsas.sys"	"signed but not trusted"
"AsyncMac"	"\SystemRoot\System32\drivers\asyncmac.sys"	"signed but not trusted"
"atapi"	"System32\drivers\atapi.sys"	"signed but not trusted"
"b06bdrv"	"System32\drivers\bxvbda.sys"	"signed but not trusted"
"bam"	"system32\drivers\bam.sys"	"signed but not trusted"
"BasicDisplay"	"\SystemRoot\System32\DriverStore\FileRepository\basicdisplay.inf_amd64_65ab9a260dbf7467\BasicDisplay.sys"	"signed but not trusted"
"BasicRender"	"\SystemRoot\System32\DriverStore\FileRepository\basicrender.inf_amd64_df49c4daa6251397\BasicRender.sys"	"signed but not trusted"
"bcmfn2"	"\SystemRoot\System32\drivers\bcmfn2.sys"	"signed but not trusted"
"Beep"	"%SystemRoot%\System32\svchost.exe"	"signed but not trusted"
"bindflt"	"\SystemRoot\system32\drivers\bindflt.sys"	"signed but not trusted"
"bowser"	"system32\DRIVERS\bowser.sys"	"signed but not trusted"
"BtFilter"	"\SystemRoot\System32\drivers\btfilter.sys"	"signed but not trusted"
"BthA2dp"	"\SystemRoot\System32\drivers\BthA2dp.sys"	"signed but not trusted"
"BthEnum"	"\SystemRoot\System32\drivers\BthEnum.sys"	"signed but not trusted"
"BthHFAud"	"\SystemRoot\System32\drivers\BthHfAud.sys"	"signed but not trusted"
"BthHFEnum"	"\SystemRoot\System32\drivers\bthhfenum.sys"	"signed but not trusted"
"BthLEEnum"	"\SystemRoot\System32\drivers\Microsoft.Bluetooth.Legacy.LEEnumerator.sys"	"signed but not trusted"
"BthMini"	"\SystemRoot\System32\drivers\BTHMINI.sys"	"signed but not trusted"
"BTHMODEM"	"\SystemRoot\System32\drivers\bthmodem.sys"	"signed but not trusted"
"BthPan"	"\SystemRoot\System32\drivers\bthpan.sys"	"signed but not trusted"
"BTHPORT"	"\SystemRoot\System32\drivers\BTHport.sys"	"signed but not trusted"
"BTHUSB"	"\SystemRoot\System32\drivers\BTHUSB.sys"	"signed but not trusted"
"bttflt"	"System32\drivers\bttflt.sys"	"signed but not trusted"
"buttonconverter"	"\SystemRoot\System32\drivers\buttonconverter.sys"	"signed but not trusted"
"CAD"	"\SystemRoot\System32\drivers\CAD.sys"	"signed but not trusted"
"cdfs"	"system32\DRIVERS\cdfs.sys"	"signed but not trusted"
"cdrom"	"\SystemRoot\System32\drivers\cdrom.sys"	"signed but not trusted"
"CH341SER_A64"	"\SystemRoot\System32\Drivers\CH341S64.SYS"	"signed but not trusted"
"cht4iscsi"	"System32\drivers\cht4sx64.sys"	"signed but not trusted"
"cht4vbd"	"\SystemRoot\System32\drivers\cht4vx64.sys"	"signed but not trusted"
"CimFS"	""	"signed but not trusted"
"circlass"	"\SystemRoot\System32\drivers\circlass.sys"	"signed but not trusted"
"CldFlt"	"system32\drivers\cldflt.sys"	"signed but not trusted"
"CLFS"	"System32\drivers\CLFS.sys"	"signed but not trusted"
"CmBatt"	"\SystemRoot\System32\drivers\CmBatt.sys"	"signed but not trusted"
"CNG"	"System32\Drivers\cng.sys"	"signed but not trusted"
"cnghwassist"	"System32\DRIVERS\cnghwassist.sys"	"signed but not trusted"
"CompositeBus"	"\SystemRoot\System32\DriverStore\FileRepository\compositebus.inf_amd64_7500cffa210c6946\CompositeBus.sys"	"signed but not trusted"
"condrv"	"System32\drivers\condrv.sys"	"signed but not trusted"
"dam"	"system32\drivers\dam.sys"	"signed but not trusted"
"Dfsc"	"System32\Drivers\dfsc.sys"	"signed but not trusted"
"disk"	"System32\drivers\disk.sys"	"signed but not trusted"
"dmvsc"	"\SystemRoot\System32\drivers\dmvsc.sys"	"signed but not trusted"
"dptf_acpi"	"\SystemRoot\System32\drivers\dptf_acpi.sys"	"signed but not trusted"
"dptf_cpu"	"\SystemRoot\System32\drivers\dptf_cpu.sys"	"signed but not trusted"
"drmkaud"	"\SystemRoot\System32\drivers\drmkaud.sys"	"signed but not trusted"
"DXGKrnl"	"\SystemRoot\System32\drivers\dxgkrnl.sys"	"signed but not trusted"
"ebdrv"	"System32\drivers\evbda.sys"	"signed but not trusted"
"EhStorClass"	"System32\drivers\EhStorClass.sys"	"signed but not trusted"
"EhStorTcgDrv"	"System32\drivers\EhStorTcgDrv.sys"	"signed but not trusted"
"ErrDev"	"\SystemRoot\System32\drivers\errdev.sys"	"signed but not trusted"
"esif_lf"	"\SystemRoot\system32\DRIVERS\esif_lf.sys"	"signed but not trusted"
"ew_usbccgpfilter"	"\SystemRoot\System32\drivers\ew_usbccgpfilter.sys"	"signed but not trusted"
"exfat"	""	"signed but not trusted"
"fastfat"	""	"signed but not trusted"
"fdc"	"\SystemRoot\System32\drivers\fdc.sys"	"signed but not trusted"
"FileCrypt"	"system32\drivers\filecrypt.sys"	"signed but not trusted"
"FileInfo"	"System32\drivers\fileinfo.sys"	"signed but not trusted"
"Filetrace"	"system32\drivers\filetrace.sys"	"signed but not trusted"
"flpydisk"	"\SystemRoot\System32\drivers\flpydisk.sys"	"signed but not trusted"
"FltMgr"	"system32\drivers\fltmgr.sys"	"signed but not trusted"
"FsDepends"	"System32\drivers\FsDepends.sys"	"signed but not trusted"
"fvevol"	"System32\DRIVERS\fvevol.sys"	"signed but not trusted"
"gencounter"	"\SystemRoot\System32\drivers\vmgencounter.sys"	"signed but not trusted"
"genericusbfn"	"\SystemRoot\System32\DriverStore\FileRepository\genericusbfn.inf_amd64_53931f0ae21d6d2c\genericusbfn.sys"	"signed but not trusted"
"GPIOClx0101"	"System32\Drivers\msgpioclx.sys"	"signed but not trusted"
"GpuEnergyDrv"	"System32\drivers\gpuenergydrv.sys"	"signed but not trusted"
"hcmon"	"\SystemRoot\system32\DRIVERS\hcmon.sys"	"signed but not trusted"
"HdAudAddService"	"\SystemRoot\System32\drivers\HdAudio.sys"	"signed but not trusted"
"HDAudBus"	"\SystemRoot\System32\drivers\HDAudBus.sys"	"signed but not trusted"
"HidBatt"	"\SystemRoot\System32\drivers\HidBatt.sys"	"signed but not trusted"
"HidBth"	"\SystemRoot\System32\drivers\hidbth.sys"	"signed but not trusted"
"HidEventFilter"	"\SystemRoot\System32\DriverStore\FileRepository\hideventfilter.inf_amd64_ca1148cff9a7eea6\HidEventFilter.sys"	"signed but not trusted"
"hidi2c"	"\SystemRoot\System32\drivers\hidi2c.sys"	"signed but not trusted"
"hidinterrupt"	"\SystemRoot\System32\drivers\hidinterrupt.sys"	"signed but not trusted"
"HidIr"	"\SystemRoot\System32\drivers\hidir.sys"	"signed but not trusted"
"hidspi"	"\SystemRoot\System32\drivers\hidspi.sys"	"signed but not trusted"
"HidUsb"	"\SystemRoot\System32\drivers\hidusb.sys"	"signed but not trusted"
"HID_PCI"	"\SystemRoot\System32\drivers\HID_PCI.sys"	"signed but not trusted"
"HpSAMD"	"System32\drivers\HpSAMD.sys"	"signed but not trusted"
"HTTP"	"system32\drivers\HTTP.sys"	"signed but not trusted"
"hvcrash"	"\SystemRoot\System32\drivers\hvcrash.sys"	"signed but not trusted"
"hvservice"	"system32\drivers\hvservice.sys"	"signed but not trusted"
"HwNClx0101"	"System32\Drivers\mshwnclx.sys"	"signed but not trusted"
"hwpolicy"	"System32\drivers\hwpolicy.sys"	"signed but not trusted"
"hyperkbd"	"\SystemRoot\System32\drivers\hyperkbd.sys"	"signed but not trusted"
"HyperVideo"	"\SystemRoot\System32\drivers\HyperVideo.sys"	"signed but not trusted"
"i8042prt"	"\SystemRoot\System32\drivers\i8042prt.sys"	"signed but not trusted"
"iagpio"	"\SystemRoot\System32\drivers\iagpio.sys"	"signed but not trusted"
"iai2c"	"\SystemRoot\System32\drivers\iai2c.sys"	"signed but not trusted"
"iaLPSS2i_GPIO2"	"\SystemRoot\System32\drivers\iaLPSS2i_GPIO2.sys"	"signed but not trusted"
"iaLPSS2i_GPIO2_BXT_P"	"\SystemRoot\System32\drivers\iaLPSS2i_GPIO2_BXT_P.sys"	"signed but not trusted"
"iaLPSS2i_GPIO2_CNL"	"\SystemRoot\System32\drivers\iaLPSS2i_GPIO2_CNL.sys"	"signed but not trusted"
"iaLPSS2i_GPIO2_GLK"	"\SystemRoot\System32\drivers\iaLPSS2i_GPIO2_GLK.sys"	"signed but not trusted"
"iaLPSS2i_I2C"	"\SystemRoot\System32\drivers\iaLPSS2i_I2C.sys"	"signed but not trusted"
"iaLPSS2i_I2C_BXT_P"	"\SystemRoot\System32\drivers\iaLPSS2i_I2C_BXT_P.sys"	"signed but not trusted"
"iaLPSS2i_I2C_CNL"	"\SystemRoot\System32\drivers\iaLPSS2i_I2C_CNL.sys"	"signed but not trusted"
"iaLPSS2i_I2C_GLK"	"\SystemRoot\System32\drivers\iaLPSS2i_I2C_GLK.sys"	"signed but not trusted"
"iaLPSS2_GPIO2"	"\SystemRoot\System32\DriverStore\FileRepository\ialpss2_gpio2_skl.inf_amd64_e79b9f98409084db\iaLPSS2_GPIO2.sys"	"signed but not trusted"
"iaLPSS2_I2C"	"\SystemRoot\System32\DriverStore\FileRepository\ialpss2_i2c_skl.inf_amd64_5b7885d62ac7afad\iaLPSS2_I2C.sys"	"signed but not trusted"
"iaLPSSi_GPIO"	"\SystemRoot\System32\drivers\iaLPSSi_GPIO.sys"	"signed but not trusted"
"iaLPSSi_I2C"	"\SystemRoot\System32\drivers\iaLPSSi_I2C.sys"	"signed but not trusted"
"iaStorAVC"	"System32\drivers\iaStorAVC.sys"	"signed but not trusted"
"iaStorV"	"System32\drivers\iaStorV.sys"	"signed but not trusted"
"ibbus"	"\SystemRoot\System32\drivers\ibbus.sys"	"signed but not trusted"
"igfx"	"\SystemRoot\System32\DriverStore\FileRepository\igdlh64.inf_amd64_0e885955e29b0a55\igdkmd64.sys"	"signed but not trusted"
"IndirectKmd"	"\SystemRoot\System32\drivers\IndirectKmd.sys"	"signed but not trusted"
"IntcAudioBus"	"\SystemRoot\System32\drivers\IntcAudioBus.sys"	"signed but not trusted"
"IntcAzAudAddService"	"\SystemRoot\system32\drivers\RTKVHD64.sys"	"signed but not trusted"
"IntcDAud"	"\SystemRoot\System32\DriverStore\FileRepository\intcdaud.inf_amd64_1b570d7b9a790b1a\IntcDAud.sys"	"signed but not trusted"
"IntcOED"	"\SystemRoot\System32\drivers\IntcOED.sys"	"signed but not trusted"
"intelide"	"System32\drivers\intelide.sys"	"signed but not trusted"
"intelpep"	"System32\drivers\intelpep.sys"	"signed but not trusted"
"intelpmax"	"\SystemRoot\System32\drivers\intelpmax.sys"	"signed but not trusted"
"intelppm"	"\SystemRoot\System32\drivers\intelppm.sys"	"signed but not trusted"
"iorate"	"system32\drivers\iorate.sys"	"signed but not trusted"
"IpFilterDriver"	"system32\DRIVERS\ipfltdrv.sys"	"signed but not trusted"
"IPMIDRV"	"\SystemRoot\System32\drivers\IPMIDrv.sys"	"signed but not trusted"
"IPNAT"	"System32\drivers\ipnat.sys"	"signed but not trusted"
"IPT"	"\SystemRoot\System32\drivers\ipt.sys"	"signed but not trusted"
"isapnp"	"System32\drivers\isapnp.sys"	"signed but not trusted"
"iScsiPrt"	"\SystemRoot\System32\drivers\msiscsi.sys"	"signed but not trusted"
"ISH"	"\SystemRoot\System32\drivers\ISH.sys"	"signed but not trusted"
"ISH_BusDriver"	"\SystemRoot\System32\drivers\ISH_BusDriver.sys"	"signed but not trusted"
"ItSas35i"	"System32\drivers\ItSas35i.sys"	"signed but not trusted"
"kbdclass"	"\SystemRoot\System32\drivers\kbdclass.sys"	"signed but not trusted"
"kbdhid"	"\SystemRoot\System32\drivers\kbdhid.sys"	"signed but not trusted"
"kdnic"	"\SystemRoot\System32\drivers\kdnic.sys"	"signed but not trusted"
"KfeCoSvc"	"\SystemRoot\System32\drivers\RivetNetworks\Killer\KfeCo10X64.sys"	"signed but not trusted"
"KSecDD"	"System32\Drivers\ksecdd.sys"	"signed but not trusted"
"KSecPkg"	"System32\Drivers\ksecpkg.sys"	"signed but not trusted"
"ksthunk"	"\SystemRoot\system32\drivers\ksthunk.sys"	"signed but not trusted"
"lltdio"	"system32\drivers\lltdio.sys"	"signed but not trusted"
"LSI_SAS"	"System32\drivers\lsi_sas.sys"	"signed but not trusted"
"LSI_SAS2i"	"System32\drivers\lsi_sas2i.sys"	"signed but not trusted"
"LSI_SAS3i"	"System32\drivers\lsi_sas3i.sys"	"signed but not trusted"
"LSI_SSS"	"System32\drivers\lsi_sss.sys"	"signed but not trusted"
"luafv"	"\SystemRoot\system32\drivers\luafv.sys"	"signed but not trusted"
"mausbhost"	"\SystemRoot\System32\drivers\mausbhost.sys"	"signed but not trusted"
"mausbip"	"\SystemRoot\System32\drivers\mausbip.sys"	"signed but not trusted"
"MbbCx"	"system32\drivers\MbbCx.sys"	"signed but not trusted"
"megasas"	"System32\drivers\megasas.sys"	"signed but not trusted"
"megasas2i"	"System32\drivers\MegaSas2i.sys"	"signed but not trusted"
"megasas35i"	"System32\drivers\megasas35i.sys"	"signed but not trusted"
"megasr"	"System32\drivers\megasr.sys"	"signed but not trusted"
"MEIx64"	"\SystemRoot\System32\DriverStore\FileRepository\heci.inf_amd64_a54e540558404ee5\x64\TeeDriverW10x64.sys"	"signed but not trusted"
"Microsoft_Bluetooth_AvrcpTransport"	"\SystemRoot\System32\drivers\Microsoft.Bluetooth.AvrcpTransport.sys"	"signed but not trusted"
"mlx4_bus"	"\SystemRoot\System32\drivers\mlx4_bus.sys"	"signed but not trusted"
"MMCSS"	"\SystemRoot\system32\drivers\mmcss.sys"	"signed but not trusted"
"Modem"	"system32\drivers\modem.sys"	"signed but not trusted"
"monitor"	"\SystemRoot\System32\drivers\monitor.sys"	"signed but not trusted"
"mouclass"	"\SystemRoot\System32\drivers\mouclass.sys"	"signed but not trusted"
"mouhid"	"\SystemRoot\System32\drivers\mouhid.sys"	"signed but not trusted"
"mountmgr"	"System32\drivers\mountmgr.sys"	"signed but not trusted"
"mpsdrv"	"System32\drivers\mpsdrv.sys"	"signed but not trusted"
"MRxDAV"	"\SystemRoot\system32\drivers\mrxdav.sys"	"signed but not trusted"
"mrxsmb"	"system32\DRIVERS\mrxsmb.sys"	"signed but not trusted"
"mrxsmb20"	"system32\DRIVERS\mrxsmb20.sys"	"signed but not trusted"
"MsBridge"	"System32\drivers\bridge.sys"	"signed but not trusted"
"Msfs"	"%SystemRoot%\System32\msdtc.exe"	"signed but not trusted"
"msgpiowin32"	"\SystemRoot\System32\drivers\msgpiowin32.sys"	"signed but not trusted"
"mshidkmdf"	"\SystemRoot\System32\drivers\mshidkmdf.sys"	"signed but not trusted"
"mshidumdf"	"\SystemRoot\System32\drivers\mshidumdf.sys"	"signed but not trusted"
"msisadrv"	"System32\drivers\msisadrv.sys"	"signed but not trusted"
"MSKSSRV"	"\SystemRoot\System32\drivers\MSKSSRV.sys"	"signed but not trusted"
"MsLldp"	"system32\drivers\mslldp.sys"	"signed but not trusted"
"MSPCLOCK"	"\SystemRoot\System32\drivers\MSPCLOCK.sys"	"signed but not trusted"
"MSPQM"	"\SystemRoot\System32\drivers\MSPQM.sys"	"signed but not trusted"
"MsQuic"	"system32\drivers\msquic.sys"	"signed but not trusted"
"MsRPC"	""	"signed but not trusted"
"mssmbios"	"\SystemRoot\System32\drivers\mssmbios.sys"	"signed but not trusted"
"MSTEE"	"\SystemRoot\System32\drivers\MSTEE.sys"	"signed but not trusted"
"MTConfig"	"\SystemRoot\System32\drivers\MTConfig.sys"	"signed but not trusted"
"Mup"	"System32\Drivers\mup.sys"	"signed but not trusted"
"mvumis"	"System32\drivers\mvumis.sys"	"signed but not trusted"
"NativeWifiP"	"system32\DRIVERS\nwifi.sys"	"signed but not trusted"
"ndfltr"	"\SystemRoot\System32\drivers\ndfltr.sys"	"signed but not trusted"
"NDIS"	"system32\drivers\ndis.sys"	"signed but not trusted"
"NdisCap"	"System32\drivers\ndiscap.sys"	"signed but not trusted"
"NdisImPlatform"	"System32\drivers\NdisImPlatform.sys"	"signed but not trusted"
"NdisTapi"	"System32\DRIVERS\ndistapi.sys"	"signed but not trusted"
"Ndisuio"	"system32\drivers\ndisuio.sys"	"signed but not trusted"
"NdisVirtualBus"	"\SystemRoot\System32\drivers\NdisVirtualBus.sys"	"signed but not trusted"
"NdisWan"	"\SystemRoot\System32\drivers\ndiswan.sys"	"signed but not trusted"
"ndiswanlegacy"	"System32\DRIVERS\ndiswan.sys"	"signed but not trusted"
"NDKPing"	"system32\drivers\NDKPing.sys"	"signed but not trusted"
"ndproxy"	"System32\DRIVERS\NDProxy.sys"	"signed but not trusted"
"Ndu"	"system32\drivers\Ndu.sys"	"signed but not trusted"
"NetAdapterCx"	"system32\drivers\NetAdapterCx.sys"	"signed but not trusted"
"NetBIOS"	"system32\drivers\netbios.sys"	"signed but not trusted"
"NetBT"	"System32\DRIVERS\netbt.sys"	"sig